1010101011101010010100111100101001010101010101010010101010101010001111
1010110101010100101011010101010101110010010010000001100010000000010101
1101010101010101001010101010101010101000001111111111101010111110101001
1010111001101110100000011110011010100101010111001010010101010010010010
1010101011101010010100111100101001010101010101010010101010101010001111
1010110101010100101011010101010101110010010010000001100010000000010101
1101010101010101001010101010101010101000001111111111101010111110101001
1010111001101110100000011110011010100101010111001010010101010010010010
1010101011101010010100111100101001010101010101010010101010101010001111
1010110101010100101011010101010101110010010010000001100010000000010101
1101010101010101001010101010101010101000001111111111101010111110101001
1010111001101110100000011110011010100101010111001010010101010010010010
1010101011101010010100111100101001010101010101010010101010101010001111
1010110101010100101011010101010101110010010010000001100010000000010101
1101010101010101001010101010101010101000001111111111101010111110101001
1010111001101110100000011110011010100101010111001010010101010010010010
1010101011101010010100111100101001010101010101010010101010101010001111
1010110101010100101011010101010101110010010010000001100010000000010101
1101010101010101001010101010101010101000001111111111101010111110101001
1010111001101110100000011110011010100101010111001010010101010010010010
1010101011101010010100111100101001010101010101010010101010101010001111
1010110101010100101011010101010101110010010010000001100010000000010101
1101010101010101001010101010101010101000001111111111101010111110101001
1010111001101110100000011110011010100101010111001010010101010010010010
1010101011101010010100111100101001010101010101010010101010101010001111
1010110101010100101011010101010101110010010010000001100010000000010101
1101010101010101001010101010101010101000001111111111101010111110101001
1010111001101110100000011110011010100101010111001010010101010010010010
1010101011101010010100111100101001010101010101010010101010101010001111
1010110101010100101011010101010101110010010010000001100010000000010101
1101010101010101001010101010101010101000001111111111101010111110101001
1010111001101110100000011110011010100101010111001010010101010010010010
1010101011101010010100111100101001010101010101010010101010101010001111
1010110101010100101011010101010101110010010010000001100010000000010101
1101010101010101001010101010101010101000001111111111101010111110101001
1010111001101110100000011110011010100101010111001010010101010010010010
1010101011101010010100111100101001010101010101010010101010101010001111
1010110101010100101011010101010101110010010010000001100010000000010101
1101010101010101001010101010101010101000001111111111101010111110101001
1010111001101110100000011110011010100101010111001010010101010010010010
1010101011101010010100111100101001010101010101010010101010101010001111
1010110101010100101011010101010101110010010010000001100010000000010101
1101010101010101001010101010101010101000001111111111101010111110101001
1010111001101110100000011110011010100101010111001010010101010010010010
1010101011101010010100111100101001010101010101010010101010101010001111
1010110101010100101011010101010101110010010010000001100010000000010101
1101010101010101001010101010101010101000001111111111101010111110101001
1010111001101110100000011110011010100101010111001010010101010010010010
1010101011101010010100111100101001010101010101010010101010101010001111
1010110101010100101011010101010101110010010010000001100010000000010101
1101010101010101001010101010101010101000001111111111101010111110101001
1010111001101110100000011110011010100101010111001010010101010010010010
1010101011101010010100111100101001010101010101010010101010101010001111
1010110101010100101011010101010101110010010010000001100010000000010101
1101010101010101001010101010101010101000001111111111101010111110101001
1010111001101110100000011110011010100101010111001010010101010010010010
1010101011101010010100111100101001010101010101010010101010101010001111
1010110101010100101011010101010101110010010010000001100010000000010101
1101010101010101001010101010101010101000001111111111101010111110101001
1010111001101110100000011110011010100101010111001010010101010010010010
1010101011101010010100111100101001010101010101010010101010101010001111
1010110101010100101011010101010101110010010010000001100010000000010101
1101010101010101001010101010101010101000001111111111101010111110101001
1010111001101110100000011110011010100101010111001010010101010010010010
1010101011101010010100111100101001010101010101010010101010101010001111
1010110101010100101011010101010101110010010010000001100010000000010101
1101010101010101001010101010101010101000001111111111101010111110101001
1010111001101110100000011110011010100101010111001010010101010010010010
1010101011101010010100111100101001010101010101010010101010101010001111
1010110101010100101011010101010101110010010010000001100010000000010101
1101010101010101001010101010101010101000001111111111101010111110101001
1010111001101110100000011110011010100101010111001010010101010010010010
1010101011101010010100111100101001010101010101010010101010101010001111
1010110101010100101011010101010101110010010010000001100010000000010101
1101010101010101001010101010101010101000001111111111101010111110101001
1010111001101110100000011110011010100101010111001010010101010010010010
1010101011101010010100111100101001010101010101010010101010101010001111
1010110101010100101011010101010101110010010010000001100010000000010101
1101010101010101001010101010101010101000001111111111101010111110101001
1010111001101110100000011110011010100101010111001010010101010010010010
1010101011101010010100111100101001010101010101010010101010101010001111
1010110101010100101011010101010101110010010010000001100010000000010101
1101010101010101001010101010101010101000001111111111101010111110101001
1010111001101110100000011110011010100101010111001010010101010010010010
1010101011101010010100111100101001010101010101010010101010101010001111
1010110101010100101011010101010101110010010010000001100010000000010101
1101010101010101001010101010101010101000001111111111101010111110101001
1010111001101110100000011110011010100101010111001010010101010010010010
1010101011101010010100111100101001010101010101010010101010101010001111
1010110101010100101011010101010101110010010010000001100010000000010101
1101010101010101001010101010101010101000001111111111101010111110101001
1010111001101110100000011110011010100101010111001010010101010010010010
1010101011101010010100111100101001010101010101010010101010101010001111
1010110101010100101011010101010101110010010010000001100010000000010101
1101010101010101001010101010101010101000001111111111101010111110101001
1010111001101110100000011110011010100101010111001010010101010010010010